key, propensity, propensity^2, count, pos, neg
?A, 0      , 0      ,        2,        0,        2
?C, 1      , 1      ,        1,        1,        0
?D, 1      , 1      ,        1,        1,        0
?G, 0.66667, 0.44444,        3,        2,        1
?I, 0      , 0      ,        2,        0,        2
?L, 0      , 0      ,        1,        0,        1
?R, 0      , 0      ,        1,        0,        1
?S, 0.5    , 0.25   ,        2,        1,        1
?T, 1      , 1      ,        1,        1,        0
?V, 0      , 0      ,        1,        0,        1
?Y, 0      , 0      ,        1,        0,        1
A?, 0      , 0      ,        3,        0,        3
AA, 0.04595, 0.00211,      740,       34,      706
AC, 0.13462, 0.01812,      104,       14,       90
AD, 0.04386, 0.00192,      456,       20,      436
AE, 0.02424, 0.00059,      495,       12,      483
AF, 0.07819, 0.00611,      243,       19,      224
AG, 0.10339, 0.01069,      590,       61,      529
AH, 0.08025, 0.00644,      162,       13,      149
AI, 0.08012, 0.00642,      337,       27,      310
AK, 0.03704, 0.00137,      459,       17,      442
AL, 0.04863, 0.00237,      658,       32,      626
AM, 0.07639, 0.00584,      144,       11,      133
AN, 0.07927, 0.00628,      328,       26,      302
AP, 0.07772, 0.00604,      386,       30,      356
AQ, 0.04962, 0.00246,      262,       13,      249
AR, 0.06233, 0.00389,      369,       23,      346
AS, 0.08411, 0.00707,      428,       36,      392
AT, 0.07212, 0.0052 ,      416,       30,      386
AV, 0.05906, 0.00349,      491,       29,      462
AW, 0.06977, 0.00487,       86,        6,       80
AY, 0.06787, 0.00461,      221,       15,      206
A_, 0      , 0      ,       52,        0,       52
CA, 0.25263, 0.06382,       95,       24,       71
CC, 0.1    , 0.01   ,       20,        2,       18
CD, 0.1    , 0.01   ,       70,        7,       63
CE, 0.09259, 0.00857,       54,        5,       49
CF, 0.21212, 0.045  ,       33,        7,       26
CG, 0.21348, 0.04558,       89,       19,       70
CH, 0.4    , 0.16   ,       45,       18,       27
CI, 0.12766, 0.0163 ,       47,        6,       41
CK, 0.14634, 0.02142,       41,        6,       35
CL, 0.18421, 0.03393,       76,       14,       62
CM, 0.10526, 0.01108,       19,        2,       17
CN, 0.16216, 0.0263 ,       37,        6,       31
CP, 0.10938, 0.01196,       64,        7,       57
CQ, 0.15789, 0.02493,       38,        6,       32
CR, 0.06   , 0.0036 ,       50,        3,       47
CS, 0.18571, 0.03449,       70,       13,       57
CT, 0.16667, 0.02778,       72,       12,       60
CV, 0.14545, 0.02116,       55,        8,       47
CW, 0.2    , 0.04   ,       10,        2,        8
CY, 0.08333, 0.00694,       36,        3,       33
C_, 0      , 0      ,        3,        0,        3
DA, 0.09397, 0.00883,      564,       53,      511
DC, 0.14286, 0.02041,      105,       15,       90
DD, 0.07988, 0.00638,      338,       27,      311
DE, 0.06281, 0.00395,      398,       25,      373
DF, 0.07619, 0.0058 ,      315,       24,      291
DG, 0.13294, 0.01767,      504,       67,      437
DH, 0.09353, 0.00875,      139,       13,      126
DI, 0.10327, 0.01067,      397,       41,      356
DK, 0.02833, 0.0008 ,      353,       10,      343
DL, 0.06644, 0.00441,      587,       39,      548
DM, 0.08228, 0.00677,      158,       13,      145
DN, 0.09055, 0.0082 ,      254,       23,      231
DP, 0.04822, 0.00233,      394,       19,      375
DQ, 0.08252, 0.00681,      206,       17,      189
DR, 0.07034, 0.00495,      327,       23,      304
DS, 0.11662, 0.0136 ,      343,       40,      303
DT, 0.10571, 0.01118,      350,       37,      313
DV, 0.08866, 0.00786,      485,       43,      442
DW, 0.08403, 0.00706,      119,       10,      109
DY, 0.07664, 0.00587,      274,       21,      253
D_, 0      , 0      ,       18,        0,       18
EA, 0.05096, 0.0026 ,      628,       32,      596
EC, 0.13187, 0.01739,       91,       12,       79
ED, 0.04358, 0.0019 ,      413,       18,      395
EE, 0.03172, 0.00101,      536,       17,      519
EF, 0.05705, 0.00325,      298,       17,      281
EG, 0.10282, 0.01057,      496,       51,      445
EH, 0.10429, 0.01088,      163,       17,      146
EI, 0.07094, 0.00503,      437,       31,      406
EK, 0.03376, 0.00114,      474,       16,      458
EL, 0.05216, 0.00272,      671,       35,      636
EM, 0.08383, 0.00703,      167,       14,      153
EN, 0.08869, 0.00787,      327,       29,      298
EP, 0.05373, 0.00289,      335,       18,      317
EQ, 0.01875, 0.00035,      320,        6,      314
ER, 0.04304, 0.00185,      395,       17,      378
ES, 0.05067, 0.00257,      375,       19,      356
ET, 0.08223, 0.00676,      377,       31,      346
EV, 0.06522, 0.00425,      506,       33,      473
EW, 0.12097, 0.01463,      124,       15,      109
EY, 0.05856, 0.00343,      222,       13,      209
E_, 0.03448, 0.00119,       29,        1,       28
FA, 0.16667, 0.02778,      264,       44,      220
FC, 0.14583, 0.02127,       48,        7,       41
FD, 0.15414, 0.02376,      266,       41,      225
FE, 0.07692, 0.00592,      234,       18,      216
FF, 0.19231, 0.03698,      130,       25,      105
FG, 0.14366, 0.02064,      355,       51,      304
FH, 0.1875 , 0.03516,       96,       18,       78
FI, 0.17568, 0.03086,      148,       26,      122
FK, 0.06771, 0.00458,      192,       13,      179
FL, 0.14607, 0.02134,      267,       39,      228
FM, 0.14474, 0.02095,       76,       11,       65
FN, 0.125  , 0.01562,      176,       22,      154
FP, 0.15556, 0.0242 ,      225,       35,      190
FQ, 0.16031, 0.0257 ,      131,       21,      110
FR, 0.10938, 0.01196,      192,       21,      171
FS, 0.16667, 0.02778,      222,       37,      185
FT, 0.15079, 0.02274,      252,       38,      214
FV, 0.13964, 0.0195 ,      222,       31,      191
FW, 0.1875 , 0.03516,       48,        9,       39
FY, 0.16038, 0.02572,      106,       17,       89
F_, 0      , 0      ,       14,        0,       14
G?, 0      , 0      ,        3,        0,        3
GA, 0.10208, 0.01042,      578,       59,      519
GC, 0.16129, 0.02601,       93,       15,       78
GD, 0.0771 , 0.00594,      441,       34,      407
GE, 0.0782 , 0.00612,      422,       33,      389
GF, 0.0991 , 0.00982,      333,       33,      300
GG, 0.21273, 0.04526,      644,      137,      507
GH, 0.13253, 0.01756,      166,       22,      144
GI, 0.1257 , 0.0158 ,      358,       45,      313
GK, 0.05765, 0.00332,      451,       26,      425
GL, 0.09539, 0.0091 ,      608,       58,      550
GM, 0.1125 , 0.01266,      160,       18,      142
GN, 0.07735, 0.00598,      362,       28,      334
GP, 0.08136, 0.00662,      381,       31,      350
GQ, 0.07721, 0.00596,      272,       21,      251
GR, 0.09659, 0.00933,      352,       34,      318
GS, 0.12916, 0.01668,      511,       66,      445
GT, 0.121  , 0.01464,      438,       53,      385
GV, 0.12579, 0.01582,      477,       60,      417
GW, 0.1    , 0.01   ,      110,       11,       99
GY, 0.10409, 0.01083,      269,       28,      241
G_, 0      , 0      ,       41,        0,       41
H?, 0      , 0      ,        1,        0,        1
HA, 0.20853, 0.04349,      211,       44,      167
HC, 0.36   , 0.1296 ,       50,       18,       32
HD, 0.14599, 0.02131,      137,       20,      117
HE, 0.14465, 0.02092,      159,       23,      136
HF, 0.14783, 0.02185,      115,       17,       98
HG, 0.20673, 0.04274,      208,       43,      165
HH, 0.17333, 0.03004,       75,       13,       62
HI, 0.14493, 0.021  ,      138,       20,      118
HK, 0.17037, 0.02903,      135,       23,      112
HL, 0.14407, 0.02076,      236,       34,      202
HM, 0.14925, 0.02228,       67,       10,       57
HN, 0.20213, 0.04086,       94,       19,       75
HP, 0.12593, 0.01586,      135,       17,      118
HQ, 0.17308, 0.02996,      104,       18,       86
HR, 0.14286, 0.02041,      133,       19,      114
HS, 0.22973, 0.05278,      148,       34,      114
HT, 0.23448, 0.05498,      145,       34,      111
HV, 0.11538, 0.01331,      182,       21,      161
HW, 0.23404, 0.05478,       47,       11,       36
HY, 0.19565, 0.03828,       92,       18,       74
H_, 0      , 0      ,       10,        0,       10
I?, 0      , 0      ,        1,        0,        1
IA, 0.08596, 0.00739,      349,       30,      319
IC, 0.08333, 0.00694,       48,        4,       44
ID, 0.09603, 0.00922,      302,       29,      273
IE, 0.07395, 0.00547,      311,       23,      288
IF, 0.09459, 0.00895,      148,       14,      134
IG, 0.14286, 0.02041,      392,       56,      336
IH, 0.06897, 0.00476,       87,        6,       81
II, 0.07538, 0.00568,      199,       15,      184
IK, 0.09312, 0.00867,      247,       23,      224
IL, 0.09938, 0.00988,      322,       32,      290
IM, 0.12222, 0.01494,       90,       11,       79
IN, 0.10256, 0.01052,      195,       20,      175
IP, 0.08898, 0.00792,      236,       21,      215
IQ, 0.09036, 0.00817,      166,       15,      151
IR, 0.08213, 0.00674,      207,       17,      190
IS, 0.11224, 0.0126 ,      294,       33,      261
IT, 0.09623, 0.00926,      239,       23,      216
IV, 0.10566, 0.01116,      265,       28,      237
IW, 0.04762, 0.00227,       42,        2,       40
IY, 0.07194, 0.00518,      139,       10,      129
I_, 0      , 0      ,       15,        0,       15
KA, 0.05609, 0.00315,      624,       35,      589
KC, 0.15873, 0.0252 ,       63,       10,       53
KD, 0.05882, 0.00346,      357,       21,      336
KE, 0.03983, 0.00159,      477,       19,      458
KF, 0.06584, 0.00434,      243,       16,      227
KG, 0.09671, 0.00935,      517,       50,      467
KH, 0.14286, 0.02041,      140,       20,      120
KI, 0.07429, 0.00552,      350,       26,      324
KK, 0.06098, 0.00372,      410,       25,      385
KL, 0.0469 , 0.0022 ,      597,       28,      569
KM, 0.08075, 0.00652,      161,       13,      148
KN, 0.06569, 0.00432,      274,       18,      256
KP, 0.08621, 0.00743,      290,       25,      265
KQ, 0.04781, 0.00229,      251,       12,      239
KR, 0.06618, 0.00438,      272,       18,      254
KS, 0.08832, 0.0078 ,      351,       31,      320
KT, 0.10836, 0.01174,      323,       35,      288
KV, 0.07658, 0.00586,      444,       34,      410
KW, 0.07018, 0.00492,      114,        8,      106
KY, 0.07843, 0.00615,      255,       20,      235
K_, 0      , 0      ,       33,        0,       33
L?, 0      , 0      ,        2,        0,        2
LA, 0.08957, 0.00802,      681,       61,      620
LC, 0.20238, 0.04096,       84,       17,       67
LD, 0.08207, 0.00674,      463,       38,      425
LE, 0.06996, 0.00489,      486,       34,      452
LF, 0.05906, 0.00349,      254,       15,      239
LG, 0.09484, 0.00899,      601,       57,      544
LH, 0.12291, 0.01511,      179,       22,      157
LI, 0.08133, 0.00661,      332,       27,      305
LK, 0.0726 , 0.00527,      427,       31,      396
LL, 0.07285, 0.00531,      604,       44,      560
LM, 0.08553, 0.00731,      152,       13,      139
LN, 0.05983, 0.00358,      351,       21,      330
LP, 0.10514, 0.01105,      428,       45,      383
LQ, 0.07285, 0.00531,      302,       22,      280
LR, 0.07105, 0.00505,      380,       27,      353
LS, 0.10216, 0.01044,      509,       52,      457
LT, 0.09888, 0.00978,      445,       44,      401
LV, 0.08824, 0.00779,      442,       39,      403
LW, 0.10417, 0.01085,       96,       10,       86
LY, 0.0796 , 0.00634,      201,       16,      185
L_, 0.10345, 0.0107 ,       29,        3,       26
MA, 0.14966, 0.0224 ,      147,       22,      125
MC, 0.04545, 0.00207,       22,        1,       21
MD, 0.07759, 0.00602,      116,        9,      107
ME, 0.08264, 0.00683,      121,       10,      111
MF, 0.11475, 0.01317,       61,        7,       54
MG, 0.16981, 0.02884,      159,       27,      132
MH, 0.18519, 0.03429,       54,       10,       44
MI, 0.16049, 0.02576,       81,       13,       68
MK, 0.11504, 0.01324,      113,       13,      100
ML, 0.09494, 0.00901,      158,       15,      143
MM, 0.02083, 0.00043,       48,        1,       47
MN, 0.11765, 0.01384,      102,       12,       90
MP, 0.10417, 0.01085,       96,       10,       86
MQ, 0.12987, 0.01687,       77,       10,       67
MR, 0.16364, 0.02678,      110,       18,       92
MS, 0.19626, 0.03852,      107,       21,       86
MT, 0.10753, 0.01156,       93,       10,       83
MV, 0.11304, 0.01278,      115,       13,      102
MW, 0.22727, 0.05165,       22,        5,       17
MY, 0.14   , 0.0196 ,       50,        7,       43
M_, 0.04167, 0.00174,       48,        2,       46
NA, 0.1037 , 0.01075,      405,       42,      363
NC, 0.17857, 0.03189,       56,       10,       46
ND, 0.11111, 0.01235,      252,       28,      224
NE, 0.05229, 0.00273,      306,       16,      290
NF, 0.09859, 0.00972,      213,       21,      192
NG, 0.14461, 0.02091,      408,       59,      349
NH, 0.13131, 0.01724,       99,       13,       86
NI, 0.10256, 0.01052,      273,       28,      245
NK, 0.08812, 0.00777,      261,       23,      238
NL, 0.08665, 0.00751,      427,       37,      390
NM, 0.15254, 0.02327,      118,       18,      100
NN, 0.06034, 0.00364,      232,       14,      218
NP, 0.08046, 0.00647,      261,       21,      240
NQ, 0.06145, 0.00378,      179,       11,      168
NR, 0.07292, 0.00532,      192,       14,      178
NS, 0.10569, 0.01117,      246,       26,      220
NT, 0.11278, 0.01272,      266,       30,      236
NV, 0.12849, 0.01651,      358,       46,      312
NW, 0.15385, 0.02367,       91,       14,       77
NY, 0.09392, 0.00882,      181,       17,      164
N_, 0      , 0      ,       18,        0,       18
PA, 0.07125, 0.00508,      407,       29,      378
PC, 0.09859, 0.00972,       71,        7,       64
PD, 0.0343 , 0.00118,      379,       13,      366
PE, 0.03364, 0.00113,      327,       11,      316
PF, 0.04741, 0.00225,      232,       11,      221
PG, 0.08274, 0.00685,      423,       35,      388
PH, 0.02344, 0.00055,      128,        3,      125
PI, 0.07527, 0.00567,      279,       21,      258
PK, 0.05818, 0.00339,      275,       16,      259
PL, 0.0636 , 0.00404,      456,       29,      427
PM, 0.02727, 0.00074,      110,        3,      107
PN, 0.044  , 0.00194,      250,       11,      239
PP, 0.08451, 0.00714,      213,       18,      195
PQ, 0.02874, 0.00083,      174,        5,      169
PR, 0.07143, 0.0051 ,      238,       17,      221
PS, 0.07029, 0.00494,      313,       22,      291
PT, 0.09467, 0.00896,      338,       32,      306
PV, 0.0675 , 0.00456,      400,       27,      373
PW, 0.03797, 0.00144,       79,        3,       76
PY, 0.03743, 0.0014 ,      187,        7,      180
P_, 0.06897, 0.00476,       29,        2,       27
QA, 0.07102, 0.00504,      352,       25,      327
QC, 0.08929, 0.00797,       56,        5,       51
QD, 0.07212, 0.0052 ,      208,       15,      193
QE, 0.03514, 0.00124,      313,       11,      302
QF, 0.07647, 0.00585,      170,       13,      157
QG, 0.09615, 0.00925,      312,       30,      282
QH, 0.08571, 0.00735,      105,        9,       96
QI, 0.0766 , 0.00587,      235,       18,      217
QK, 0.05042, 0.00254,      238,       12,      226
QL, 0.04239, 0.0018 ,      401,       17,      384
QM, 0.10577, 0.01119,      104,       11,       93
QN, 0.07487, 0.0056 ,      187,       14,      173
QP, 0.06593, 0.00435,      182,       12,      170
QQ, 0.03543, 0.00126,      254,        9,      245
QR, 0.03913, 0.00153,      230,        9,      221
QS, 0.08936, 0.00799,      235,       21,      214
QT, 0.06699, 0.00449,      209,       14,      195
QV, 0.06667, 0.00444,      270,       18,      252
QW, 0.04396, 0.00193,       91,        4,       87
QY, 0.08125, 0.0066 ,      160,       13,      147
Q_, 0      , 0      ,       18,        0,       18
R?, 0      , 0      ,        1,        0,        1
RA, 0.12253, 0.01501,      506,       62,      444
RC, 0.16667, 0.02778,       90,       15,       75
RD, 0.12615, 0.01591,      325,       41,      284
RE, 0.09975, 0.00995,      401,       40,      361
RF, 0.09881, 0.00976,      253,       25,      228
RG, 0.15765, 0.02485,      425,       67,      358
RH, 0.15493, 0.024  ,      142,       22,      120
RI, 0.10264, 0.01053,      341,       35,      306
RK, 0.09594, 0.0092 ,      271,       26,      245
RL, 0.12271, 0.01506,      546,       67,      479
RM, 0.12329, 0.0152 ,      146,       18,      128
RN, 0.13131, 0.01724,      198,       26,      172
RP, 0.12355, 0.01527,      259,       32,      227
RQ, 0.08511, 0.00724,      235,       20,      215
RR, 0.08365, 0.007  ,      263,       22,      241
RS, 0.15282, 0.02336,      301,       46,      255
RT, 0.14478, 0.02096,      297,       43,      254
RV, 0.10835, 0.01174,      443,       48,      395
RW, 0.14583, 0.02127,       96,       14,       82
RY, 0.12683, 0.01609,      205,       26,      179
R_, 0.05556, 0.00309,       18,        1,       17
S?, 0      , 0      ,        2,        0,        2
SA, 0.09363, 0.00877,      502,       47,      455
SC, 0.13953, 0.01947,       86,       12,       74
SD, 0.07792, 0.00607,      308,       24,      284
SE, 0.05233, 0.00274,      344,       18,      326
SF, 0.11067, 0.01225,      253,       28,      225
SG, 0.14444, 0.02086,      540,       78,      462
SH, 0.10563, 0.01116,      142,       15,      127
SI, 0.07895, 0.00623,      342,       27,      315
SK, 0.05502, 0.00303,      309,       17,      292
SL, 0.0917 , 0.00841,      578,       53,      525
SM, 0.12727, 0.0162 ,      110,       14,       96
SN, 0.09692, 0.00939,      227,       22,      205
SP, 0.0836 , 0.00699,      311,       26,      285
SQ, 0.0787 , 0.00619,      216,       17,      199
SR, 0.10039, 0.01008,      259,       26,      233
SS, 0.11086, 0.01229,      451,       50,      401
ST, 0.11404, 0.013  ,      342,       39,      303
SV, 0.09476, 0.00898,      401,       38,      363
SW, 0.04762, 0.00227,      105,        5,      100
SY, 0.08072, 0.00652,      223,       18,      205
S_, 0.03774, 0.00142,       53,        2,       51
TA, 0.07143, 0.0051 ,      476,       34,      442
TC, 0.10112, 0.01023,       89,        9,       80
TD, 0.07541, 0.00569,      305,       23,      282
TE, 0.05988, 0.00359,      334,       20,      314
TF, 0.06367, 0.00405,      267,       17,      250
TG, 0.11613, 0.01349,      465,       54,      411
TH, 0.09244, 0.00854,      119,       11,      108
TI, 0.07309, 0.00534,      301,       22,      279
TK, 0.07018, 0.00492,      285,       20,      265
TL, 0.04537, 0.00206,      529,       24,      505
TM, 0.04854, 0.00236,      103,        5,       98
TN, 0.08051, 0.00648,      236,       19,      217
TP, 0.08333, 0.00694,      336,       28,      308
TQ, 0.04663, 0.00217,      193,        9,      184
TR, 0.07905, 0.00625,      253,       20,      233
TS, 0.13235, 0.01752,      340,       45,      295
TT, 0.09554, 0.00913,      314,       30,      284
TV, 0.07292, 0.00532,      384,       28,      356
TW, 0.07627, 0.00582,      118,        9,      109
TY, 0.06481, 0.0042 ,      216,       14,      202
T_, 0.03448, 0.00119,       29,        1,       28
VA, 0.08498, 0.00722,      506,       43,      463
VC, 0.13636, 0.0186 ,       66,        9,       57
VD, 0.06094, 0.00371,      361,       22,      339
VE, 0.04987, 0.00249,      381,       19,      362
VF, 0.1005 , 0.0101 ,      199,       20,      179
VG, 0.11834, 0.01401,      507,       60,      447
VH, 0.08661, 0.0075 ,      127,       11,      116
VI, 0.06273, 0.00394,      271,       17,      254
VK, 0.07571, 0.00573,      317,       24,      293
VL, 0.06935, 0.00481,      447,       31,      416
VM, 0.09821, 0.00965,      112,       11,      101
VN, 0.06316, 0.00399,      285,       18,      267
VP, 0.09169, 0.00841,      349,       32,      317
VQ, 0.07614, 0.0058 ,      197,       15,      182
VR, 0.09122, 0.00832,      296,       27,      269
VS, 0.10089, 0.01018,      337,       34,      303
VT, 0.08581, 0.00736,      303,       26,      277
VV, 0.08838, 0.00781,      396,       35,      361
VW, 0.07895, 0.00623,       76,        6,       70
VY, 0.05814, 0.00338,      172,       10,      162
V_, 0.07407, 0.00549,       27,        2,       25
WA, 0.18349, 0.03367,      109,       20,       89
WC, 0.30769, 0.09467,       13,        4,        9
WD, 0.18584, 0.03454,      113,       21,       92
WE, 0.16216, 0.0263 ,      111,       18,       93
WF, 0.15517, 0.02408,       58,        9,       49
WG, 0.21374, 0.04568,      131,       28,      103
WH, 0.13636, 0.0186 ,       44,        6,       38
WI, 0.16393, 0.02687,       61,       10,       51
WK, 0.14141, 0.02   ,       99,       14,       85
WL, 0.1938 , 0.03756,      129,       25,      104
WM, 0.10714, 0.01148,       28,        3,       25
WN, 0.19318, 0.03732,       88,       17,       71
WP, 0.16049, 0.02576,       81,       13,       68
WQ, 0.1573 , 0.02474,       89,       14,       75
WR, 0.14103, 0.01989,       78,       11,       67
WS, 0.27778, 0.07716,      108,       30,       78
WT, 0.19469, 0.0379 ,      113,       22,       91
WV, 0.21101, 0.04452,      109,       23,       86
WW, 0      , 0      ,        9,        0,        9
WY, 0.22222, 0.04938,       63,       14,       49
W_, 0.33333, 0.11111,        6,        2,        4
YA, 0.18021, 0.03248,      283,       51,      232
YC, 0.12069, 0.01457,       58,        7,       51
YD, 0.14229, 0.02025,      253,       36,      217
YE, 0.12381, 0.01533,      210,       26,      184
YF, 0.21875, 0.04785,      128,       28,      100
YG, 0.19018, 0.03617,      326,       62,      264
YH, 0.16092, 0.0259 ,       87,       14,       73
YI, 0.12953, 0.01678,      193,       25,      168
YK, 0.125  , 0.01562,      224,       28,      196
YL, 0.09818, 0.00964,      275,       27,      248
YM, 0.14286, 0.02041,       63,        9,       54
YN, 0.11236, 0.01262,      178,       20,      158
YP, 0.14634, 0.02142,      205,       30,      175
YQ, 0.09722, 0.00945,      144,       14,      130
YR, 0.19653, 0.03862,      173,       34,      139
YS, 0.19835, 0.03934,      242,       48,      194
YT, 0.16895, 0.02854,      219,       37,      182
YV, 0.16744, 0.02804,      215,       36,      179
YW, 0.10909, 0.0119 ,       55,        6,       49
YY, 0.2028 , 0.04113,      143,       29,      114
Y_, 0.08333, 0.00694,       12,        1,       11
